1111111111111
1ECCCCCCCCCC1
111CC11111CC1
1CCC11CPCCCX1
1111111111111
