111111111111111111111111111111111111111
110000E001111000000000C0000000000000001
11111111111C000000000000000000000000011
100000000000000000001111111111111111111
1000000000000000C0000000000C00111111111
1111000000000000000111000001111C0000011
100000001111000000000000111111111100001
1100001110000000000000000011111000C0011
10001110000000000000C000000000100000001
10P01C000000000000000000000000000000001
111111111111111111111111111111111111111
