11111111111111111111
1010100C000000000011
111111111010000C0001
10000000000000000001
10011100000000001111
100000000P0000000111
10C00100010000000001
100001001E1000000001
100011000C0000000001
10011110000000000001
11000000001111001001
1001000000000C001111
10C10000000000001001
111100000000000000C1
11111111111111111111
