1111111111111
1C000000000C1
1000010011001
100C01E000001
1000001111001
1P001C00000C1
1111111111111
