1111111111
1000000001
100C000001
1000001001
100000E0P1
1111111111
1
