1111111111
1E00000011
1110000C01
1000000001
10P00000C1
1111111111
